%%%%%%%%%%%%%%%%%%%%
%...%.........%%...%
%.%.%.%%%%%%%%%%.%.%
%..................%
%%%%%%%%.%.%%%%%%%P%
%%%%%%%%..G....    %
%%%%%%%%%%%%%%%%%%%%
